beta sense fragments

beta_L1		ATGCCCTTGGACAGTGTCAAAATGGACCACACGGTTAATCGGCGGAAGGCCATGAACGC
beta_L2		ATTACACCCTCAACTCCAGCGGACTTCAGAGCTTGCAGGGATGCGTTCATGGCCTTCCG
beta_L3		CGCTGGAGTTGAGGGTGTAATGATGGATGTTTGGTGGGGCCTTGTCGAGAAGGATTCAC
beta_L4		GCCTTGTCGAGAAGGATTCACCAGGTGAATATAATTGGGGTGGGTATGCAGAATTGCTT
beta_L5		GGTGGGTATGCAGAATTGCTTGAGATGGCCAAAAAGCACGGATTAAAGGTCCAGGCGGT
beta_L6		CTGTCCCCGACATTTCCTCCACACTGATGAAATGACATAACCGCCTGGACCTTTAATCC
beta_L7		GGAGGAAATGTCGGGGACAGCTGTACGTTGCGCGCTACCGCAGAGTCCATCGGCAAACC
beta_L8		GTAGTGGCCAGCATCCGTAGGACCTGAGTGACCCCACTCCGGTTTGCCGATGGACTCTG
beta_L9		ACGGATGCTGGCCACTACAATAATTGGCCTGAAGACACGAATTTCTTCCGCAAAGAGGG
beta_L10	AGACAGGAAAAATTCGCCATACGGCGTAGTCCAGCCCCCCTCTTTGCGGAAGAAATTCG
beta_L11	CGTATGGCGAATTTTTCCTGTCTTGGTATAGCCAAATGCTTTTAGATCATGGGGAGCGC
beta_L12	CCTGTATTATGGAAGATCGCGTTTGCACTCTGCAAGATGCGCTCCCCATGATCTAAAAG
beta_L13	CAAACGCGATCTTCCATAATACAGGGGTAAAAATCTCTGTAAAAATCGCAGGGATACAC
beta_L14	GCTCCGGAGCATGGGACCGCGTCCCGTAGTGCCAGTGTATCCCTGCGATTTTTACAGAG
beta_L15	GTCCCATGCTCCGGAGCTGACGGCTGGTTATTACAACACTCGCTTCCGGGACGGTTATT
beta_L16	AATATTGCGCCATGGCGAGCTAACATCTGCGCAATGGGCAAATAACCGTCCCGGAAGCG
beta_L17	CTCGCCATGGCGCAATATTCAACTTCACGTGTATCGAAATGCGGGATCACGAACAACCA
beta_L18	CCTGTCTTACAAGCTTTTCTGGGGCGCATTGAGCGTCCTGTGGTTGTTCGTGATCCCGC
beta_L19	CCCAGAAAAGCTTGTAAGACAGGTTGCCCTTGCTACGCAGGAGGCTCAAGTACCGCTGG
beta_L20	TGCGCGTAATCATCATAGCGTGGAAGGGCATTCTCCCCTGCCAGCGGTACTTGAGCCTC
beta_L21	CGCTATGATGATTACGCGCATGAGCAGATCCTGCGTGCAAGTGCGTTATCGATTGACGA
beta_L22	ATACGTGAACGCGCACATCTCTCTGTCTCCGGATTTCTCGTCAATCGATAACGCACTTG
beta_L23	GATGTGCGCGTTCACGTATTTGCGTATGAACCCGGATCTGTTTCAAGCCGACAATTGGA
beta_L24	CCCTCCTTCATTTTCTTAACAAACGCGACGAAACGTCTCCAATTGTCGGCTTGAAACAG
beta_L25	CGTTTGTTAAGAAAATGAAGGAGGGCAAAGACGTTCACAAATGCTGGGAGGAAGTAGAA
beta_L26	TGGCTGGGTGATATGGACGAAATGCTCAGCTTCTCTTTCTACTTCCTCCCAGCATTTGT
beta_L27	CGTCCATATCACCCAGCCATTGGTTCATGAGGCGGCGGCGGCGTTGATGCACTAA
	



antisense fragments

beta_L2_r	ATTACACCCTCAACTCCAGCGGACTTCAGAGCTTGCAGGGATGCGTTCATGGCCTTCCG
beta_L4_r	GCCTTGTCGAGAAGGATTCACCAGGTGAATATAATTGGGGTGGGTATGCAGAATTGCTT
beta_L6_r	CTGTCCCCGACATTTCCTCCACACTGATGAAATGACATAACCGCCTGGACCTTTAATCC
beta_L8_r	GTAGTGGCCAGCATCCGTAGGACCTGAGTGACCCCACTCCGGTTTGCCGATGGACTCTG
beta_L10_r	AGACAGGAAAAATTCGCCATACGGCGTAGTCCAGCCCCCCTCTTTGCGGAAGAAATTCG
beta_L12_r	CCTGTATTATGGAAGATCGCGTTTGCACTCTGCAAGATGCGCTCCCCATGATCTAAAAG
beta_L14_r	GCTCCGGAGCATGGGACCGCGTCCCGTAGTGCCAGTGTATCCCTGCGATTTTTACAGAG
beta_L16_r	AATATTGCGCCATGGCGAGCTAACATCTGCGCAATGGGCAAATAACCGTCCCGGAAGCG
beta_L18_r	CCTGTCTTACAAGCTTTTCTGGGGCGCATTGAGCGTCCTGTGGTTGTTCGTGATCCCGC
beta_L20_r	TGCGCGTAATCATCATAGCGTGGAAGGGCATTCTCCCCTGCCAGCGGTACTTGAGCCTC
beta_L22_r	ATACGTGAACGCGCACATCTCTCTGTCTCCGGATTTCTCGTCAATCGATAACGCACTTG
beta_L24_r	CCCTCCTTCATTTTCTTAACAAACGCGACGAAACGTCTCCAATTGTCGGCTTGAAACAG
beta_L26_r	TGGCTGGGTGATATGGACGAAATGCTCAGCTTCTCTTTCTACTTCCTCCCAGCATTTGT





block primers

β_L9_overlap_5	CGAATTTCTTCCGCAAAGAGGG
β_L9_overlap_3	CCCTCTTTGCGGAAGAAATTCG
β_L18_overlap_5	CCCAGAAAAGCTTGTAAGACAGG
β_L18_overlap_3	CCTGTCTTACAAGCTTTTCTGGG





gene primers
	
β_5	ATGCCCTTGGACAGTGTCAA
β_3	TTAGTGCATCAACGCCGC



